{
    "title": "Sokoban Online",
    "description": "A small collection of levels without pretetions created one day of idleness whereas I missed inspiration.",
    "email": "sokoban@online.fr",
    "url": "http://sokoban.online.fr",
    "levelCollection": {
        "copyright": "François Marques",
        "maxWidth": 8,
        "maxHeight": 9,
        "levels": [
            {
                "id": "* -&gt; S",
                "width": 8,
                "height": 9,
                "room": [
                    "########",
                    "#@     #",
                    "# $..* #",
                    "# .$$  #",
                    "# $..$ #",
                    "#  $$. #",
                    "# *..$ #",
                    "#      #",
                    "########"
                ]
            },
            {
                "id": "S -&gt; O",
                "width": 8,
                "height": 9,
                "room": [
                    "########",
                    "#@     #",
                    "#  **$ #",
                    "# *  . #",
                    "# .$$. #",
                    "# .  * #",
                    "# $**  #",
                    "#      #",
                    "########"
                ]
            },
            {
                "id": "O -&gt; K",
                "width": 8,
                "height": 9,
                "room": [
                    "########",
                    "#@     #",
                    "# .$$. #",
                    "# * .$ #",
                    "# *. $ #",
                    "# * .$ #",
                    "# .$$. #",
                    "#      #",
                    "########"
                ]
            },
            {
                "id": "K -&gt; O",
                "width": 8,
                "height": 9,
                "room": [
                    "########",
                    "#@     #",
                    "# $..$ #",
                    "# * $. #",
                    "# *$ . #",
                    "# * $. #",
                    "# $..$ #",
                    "#      #",
                    "########"
                ]
            },
            {
                "id": "O -&gt; B",
                "width": 8,
                "height": 9,
                "room": [
                    "########",
                    "#@     #",
                    "# .*$  #",
                    "# * .$ #",
                    "# *. $ #",
                    "# * .$ #",
                    "# .*$  #",
                    "#      #",
                    "########"
                ]
            },
            {
                "id": "B -&gt; A",
                "width": 8,
                "height": 9,
                "room": [
                    "########",
                    "#@     #",
                    "# $$.  #",
                    "# $.$. #",
                    "# $*.. #",
                    "# $.$. #",
                    "# $* . #",
                    "#      #",
                    "########"
                ]
            },
            {
                "id": "A -&gt; N",
                "width": 8,
                "height": 9,
                "room": [
                    "########",
                    "#@     #",
                    "# . $. #",
                    "# .* * #",
                    "# .$** #",
                    "# .$ * #",
                    "#  $ $ #",
                    "#      #",
                    "########"
                ]
            },
            {
                "id": "N -&gt; *",
                "width": 8,
                "height": 9,
                "room": [
                    "########",
                    "#@     #",
                    "# *  * #",
                    "# $*.$ #",
                    "# * $* #",
                    "# $..$ #",
                    "# .  . #",
                    "#      #",
                    "########"
                ]
            },
            {
                "id": "* -&gt; O",
                "width": 8,
                "height": 9,
                "room": [
                    "########",
                    "#@     #",
                    "# $..$ #",
                    "# .$$. #",
                    "# *  * #",
                    "# .$$. #",
                    "# $..$ #",
                    "#      #",
                    "########"
                ]
            },
            {
                "id": "O -&gt; N",
                "width": 8,
                "height": 9,
                "room": [
                    "########",
                    "#@     #",
                    "#  $$  #",
                    "# *  * #",
                    "# *. * #",
                    "# * .* #",
                    "# .$$. #",
                    "#      #",
                    "########"
                ]
            },
            {
                "id": "N -&gt; L",
                "width": 8,
                "height": 9,
                "room": [
                    "########",
                    "#@     #",
                    "# ..   #",
                    "# $. $ #",
                    "# $* $ #",
                    "# $.$* #",
                    "# *..* #",
                    "#      #",
                    "########"
                ]
            },
            {
                "id": "L -&gt; I",
                "width": 8,
                "height": 9,
                "room": [
                    "########",
                    "#@     #",
                    "# $*.. #",
                    "#  $.  #",
                    "#  $.  #",
                    "#  $.$ #",
                    "# **** #",
                    "#      #",
                    "########"
                ]
            },
            {
                "id": "I -&gt; N",
                "width": 8,
                "height": 9,
                "room": [
                    "########",
                    "#@     #",
                    "# .$$* #",
                    "# ..$. #",
                    "# . *. #",
                    "# . $. #",
                    "# $$$$ #",
                    "#      #",
                    "########"
                ]
            },
            {
                "id": "N -&gt; E",
                "width": 8,
                "height": 9,
                "room": [
                    "########",
                    "#@     #",
                    "# *..$ #",
                    "# *$ $ #",
                    "# *.$$ #",
                    "# *  $ #",
                    "# ...  #",
                    "#      #",
                    "########"
                ]
            },
            {
                "id": "E -&gt; *",
                "width": 8,
                "height": 9,
                "room": [
                    "########",
                    "#@     #",
                    "# *$$. #",
                    "# $..  #",
                    "# *$ . #",
                    "# $..  #",
                    "# *$$. #",
                    "#      #",
                    "########"
                ]
            }
        ]
    }
}
